1 10 2616 1173 2001 869 715 1334 2642 98 915 2666 
1 14 2666 1493 495 2685 760 1529 2522 1609 2448 389 327 1790 237 519 
1 9 2522 2727 953 885 1977 1260 523 1859 2221 
1 8 1260 2756 1796 84 1925 808 2314 1482 
1 5 1482 1206 2848 1978 2838 
1 9 1482 2850 2842 181 2833 1953 1429 2238 849 
1 4 2540 654 473 65 
1 3 2540 1552 849 
1 3 65 1611 2008 
1 5 121 2086 1169 2385 65 
1 4 849 2033 1451 2309 
1 4 2309 785 1819 2989 
1 4 2309 2549 889 647 
1 6 2221 2748 1659 1811 1371 1709 
1 5 2838 2290 996 2446 142 
1 5 108 1946 550 2897 142 
1 3 1600 1558 108 
1 8 142 2892 1337 2912 2344 1085 1126 647 
1 5 124 2562 1711 2889 1888 
1 5 2754 2024 1783 350 2032 
1 4 201 1820 2047 1408 
1 6 26 1638 2523 1559 940 3056 
1 12 195 3272 1567 786 3222 72 3188 3177 2060 164 2544 26 
1 9 2904 1584 690 236 1244 990 3026 3042 3056 
1 5 940 926 556 1031 1480 
1 10 1600 962 1505 1434 1544 3001 2059 287 549 3056 
1 14 195 998 1395 1458 1553 1486 1017 3258 2533 216 3287 857 717 821 
1 6 394 3296 503 3310 37 821 
1 8 394 3314 1622 587 312 3358 1669 104 
1 5 394 456 2027 577 3237 
1 10 2310 1204 1654 1864 3201 2409 1951 868 1213 3237 
1 5 1463 615 3228 525 3237 
1 4 711 2107 3223 1463 
1 6 3237 525 3198 227 1738 1471 
1 8 1471 663 1060 1843 314 1338 2537 469 
1 7 1471 1578 3133 1134 2081 1110 2412 
1 5 711 1866 1620 62 3132 
1 5 711 1357 973 516 2292 
1 8 2310 1145 1712 1763 1484 292 770 3330 
1 10 2310 2020 1491 3169 221 3151 2194 1872 876 1802 
1 9 1802 192 2272 337 2284 1629 895 3230 2002 
1 8 1802 3088 160 2323 916 1268 3031 3018 
1 5 1815 1369 1268 3031 3018 
1 11 2891 2896 1758 2039 82 2118 2514 1239 2981 1742 3018 
1 14 1986 1037 1326 497 750 2902 2913 2301 1668 2969 693 2987 1047 1815 
1 12 1986 391 1966 1302 2839 2220 1296 2339 812 712 2086 121 
1 7 519 2751 683 2765 205 1325 2008 
1 7 2743 266 1997 2153 2550 1781 2839 
1 10 532 2739 1671 2291 623 275 1643 137 1781 2839 
1 13 305 1074 1700 1024 50 1564 2630 552 2637 18 1410 2353 915 
1 9 305 1074 1700 2614 539 1594 2162 1585 1199 
1 12 2221 1873 2709 71 2695 187 955 1841 2653 2646 2640 305 
1 9 2284 769 910 819 3119 1973 975 489 905 
1 17 2891 931 2926 1147 2944 2952 307 1682 329 1271 2462 1472 3037 404 2257 489 905 
1 11 2891 400 2416 2531 2127 860 1695 204 1568 2900 432 
1 6 304 271 3051 1694 670 1269 
1 6 304 3116 416 3152 1862 299 
1 5 3101 57 3104 1335 304 
1 4 3101 1487 3139 379 
1 5 3101 1091 3095 458 3060 
1 4 379 2498 3153 811 
1 3 299 1068 3218 
1 8 1212 2470 1773 1731 1066 659 2404 299 
1 14 1212 197 3299 7 2473 3292 403 2000 106 843 3289 559 3311 41 
1 8 1212 79 3302 787 3304 662 15 1710 
1 14 905 2169 2231 942 1881 1070 555 1014 572 2174 3278 3295 1008 41 
1 4 160 563 2180 451
1 10 3151 338 3115 1746 3081 1692 2319 1407 1254 2976
1 2 693 1742
1 3 2008 145 2339
1 10 519 2729 1910 1226 764 946 2693 207 2681 495
1 6 314 1378 1450 877 1161 2989